"geo_id","tot_pop_race","pop_white","pop_black","pop_native","pop_asian","pop_pac_isl","pop_other","pop_two_plus","tot_pop_hisp","pop_not_hisp","pop_white_not_hisp","pop_hisp","tot_pop_income","pop_in_poverty","per_cap_income","pop_nonwhite","pct_white","pct_nonwhite","pct_black","pct_asian","pct_pac_isl","pct_native","pct_other","pct_two_plus","pct_hisp","pct_white_not_hisp","pct_in_poverty"
"510131001001",1209,1021,22,0,65,0,16,85,1209,1045,878,164,1209,29,82957,188,84.449958643507,15.550041356493,1.81968569065343,5.37634408602151,0,0,1.32340777502068,7.03060380479735,13.564929693962,72.6220016542597,2.39867659222498
"510131001002",921,661,0,0,235,0,7,18,921,832,579,89,921,18,90715,260,71.7698154180239,28.2301845819761,0,25.5157437567861,0,0,0.760043431053203,1.95439739413681,9.66340933767644,62.8664495114006,1.95439739413681
"510131001003",1172,1090,13,0,12,0,52,5,1172,1044,1014,128,1172,7,87065,82,93.0034129692833,6.99658703071673,1.10921501706485,1.02389078498294,0,0,4.43686006825939,0.426621160409556,10.9215017064846,86.518771331058,0.597269624573379
"510131001004",1994,1839,0,0,118,0,24,13,1994,1792,1661,202,1994,8,78351,155,92.2266800401204,7.77331995987964,0,5.91775325977934,0,0,1.20361083249749,0.651955867602808,10.1303911735206,83.2998996990973,0.401203610832498
"510131002001",1344,1135,2,47,35,0,0,125,1344,1241,1073,103,1344,4,97045,209,84.4494047619048,15.5505952380952,0.148809523809524,2.60416666666667,0,3.49702380952381,0,9.30059523809524,7.66369047619048,79.8363095238095,0.297619047619048
"510131002002",1492,1416,0,0,76,0,0,0,1492,1345,1269,147,1492,63,96621,76,94.9061662198391,5.09383378016086,0,5.09383378016086,0,0,0,0,9.85254691689008,85.0536193029491,4.22252010723861
"510131002003",705,686,0,0,19,0,0,0,705,705,686,0,705,0,136811,19,97.3049645390071,2.69503546099291,0,2.69503546099291,0,0,0,0,0,97.3049645390071,0
"510131002004",1250,1181,49,0,20,0,0,0,1250,1142,1073,108,1250,20,96334,69,94.48,5.52,3.92,1.6,0,0,0,0,8.64,85.84,1.6
"510131002005",834,697,0,0,84,0,0,53,834,796,659,38,834,0,91813,137,83.5731414868106,16.4268585131894,0,10.0719424460432,0,0,0,6.35491606714628,4.55635491606715,79.0167865707434,0
"510131002006",975,877,18,0,61,0,0,19,975,912,814,63,975,27,101403,98,89.948717948718,10.051282051282,1.84615384615385,6.25641025641026,0,0,0,1.94871794871795,6.46153846153846,83.4871794871795,2.76923076923077
"510131003001",1291,1271,0,0,20,0,0,0,1291,1060,1040,231,1291,0,91774,20,98.4508133230054,1.54918667699458,0,1.54918667699458,0,0,0,0,17.8931061192874,80.557707203718,0
"510131003002",1621,1578,0,0,28,0,0,15,1621,1516,1473,105,1621,0,139229,43,97.347316471314,2.652683528686,0,1.72732880937693,0,0,0,0.925354719309069,6.47748303516348,90.8698334361505,0
"510131003003",1439,1263,21,0,155,0,0,0,1439,1439,1263,0,1439,44,96384,176,87.7692842251564,12.2307157748436,1.4593467685893,10.7713690062543,0,0,0,0,0,87.7692842251564,3.05767894371091
"510131003004",423,423,0,0,0,0,0,0,423,397,397,26,423,37,106244,0,100,0,0,0,0,0,0,0,6.14657210401891,93.8534278959811,8.74704491725768
"510131003005",1481,1102,111,0,152,0,71,45,1481,1382,1085,99,992,6,91610,379,74.40918298447,25.59081701553,7.4949358541526,10.2633355840648,0,0,4.79405806887238,3.03848750844024,6.68467251856853,73.2613099257259,0.604838709677419
"510131004001",1489,1380,0,0,52,0,18,39,1489,1369,1310,120,1479,12,125669,109,92.6796507723304,7.32034922766958,0,3.49227669576897,0,0,1.20886501007387,2.61920752182673,8.05910006715917,87.9785090664876,0.811359026369168
"510131004002",796,626,0,0,161,0,0,9,796,787,626,9,796,17,114951,170,78.643216080402,21.356783919598,0,20.2261306532663,0,0,0,1.13065326633166,1.13065326633166,78.643216080402,2.1356783919598
"510131004003",1633,1415,100,0,67,0,0,51,1633,1476,1258,157,1633,94,114818,218,86.6503368034293,13.3496631965707,6.12369871402327,4.10287813839559,0,0,0,3.12308634415187,9.61420698101653,77.0361298224127,5.75627679118187
"510131005001",1374,1052,26,0,84,0,50,162,1374,1245,1016,129,1374,30,88867,322,76.5647743813683,23.4352256186317,1.89228529839884,6.11353711790393,0,0,3.63901018922853,11.7903930131004,9.38864628820961,73.9446870451237,2.18340611353712
"510131005002",779,705,64,0,0,0,0,10,779,779,705,0,779,7,146361,74,90.5006418485237,9.49935815147626,8.21566110397946,0,0,0,0,1.28369704749679,0,90.5006418485237,0.898587933247754
"510131005003",1271,1212,0,0,46,0,0,13,1271,1256,1197,15,1271,0,118543,59,95.3579858379229,4.6420141620771,0,3.6191974822974,0,0,0,1.0228166797797,1.1801730920535,94.1778127458694,0
"510131005004",1098,946,17,0,48,0,0,87,1098,1058,926,40,1098,63,82908,152,86.1566484517304,13.8433515482696,1.54826958105647,4.37158469945355,0,0,0,7.92349726775956,3.64298724954463,84.3351548269581,5.73770491803279
"510131006001",1469,1137,81,0,95,55,33,68,1469,1147,914,322,1255,44,69508,332,77.3995915588836,22.6004084411164,5.51395507147719,6.46698434309054,3.74404356705242,0,2.24642614023145,4.62899931926481,21.9196732471069,62.2191967324711,3.50597609561753
"510131006002",915,701,3,0,44,0,50,117,915,774,604,141,915,55,75767,214,76.6120218579235,23.3879781420765,0.327868852459016,4.80874316939891,0,0,5.46448087431694,12.7868852459016,15.4098360655738,66.0109289617486,6.01092896174863
"510131006003",1083,953,51,0,43,0,0,36,1083,1047,917,36,1083,79,80160,130,87.9963065558633,12.0036934441367,4.70914127423823,3.97045244690674,0,0,0,3.32409972299169,3.32409972299169,84.6722068328717,7.29455216989843
"510131007001",1405,1053,71,0,271,0,5,5,1405,1275,928,130,1405,53,69749,352,74.9466192170819,25.0533807829181,5.05338078291815,19.288256227758,0,0,0.355871886120996,0.355871886120996,9.25266903914591,66.0498220640569,3.77224199288256
"510131007002",541,541,0,0,0,0,0,0,541,541,541,0,541,84,93071,0,100,0,0,0,0,0,0,0,0,100,15.5268022181146
"510131007003",802,653,0,0,88,0,0,61,802,752,603,50,802,38,97401,149,81.4214463840399,18.5785536159601,0,10.9725685785536,0,0,0,7.60598503740648,6.23441396508728,75.1870324189526,4.73815461346633
"510131007004",1201,1187,8,0,0,0,6,0,1201,1100,1092,101,1180,34,97473,14,98.834304746045,1.16569525395504,0.666111573688593,0,0,0,0.499583680266445,0,8.40965861781848,90.9242298084929,2.88135593220339
"510131007005",997,750,0,22,200,0,25,0,997,843,621,154,997,74,69824,247,75.2256770310933,24.7743229689067,0,20.0601805416249,0,2.20661985957874,2.50752256770311,0,15.4463390170512,62.2868605817452,7.4222668004012
"510131007006",885,429,22,0,58,0,360,16,885,525,429,360,885,349,56986,456,48.4745762711864,51.5254237288136,2.48587570621469,6.55367231638418,0,0,40.6779661016949,1.80790960451977,40.6779661016949,48.4745762711864,39.4350282485876
"510131008001",848,363,329,0,139,0,0,17,848,769,315,79,848,42,46361,485,42.8066037735849,57.1933962264151,38.7971698113208,16.3915094339623,0,0,0,2.00471698113208,9.31603773584906,37.1462264150943,4.95283018867925
"510131008002",769,451,229,0,14,0,0,75,769,672,354,97,769,52,63557,318,58.6475942782835,41.3524057217165,29.778933680104,1.82054616384915,0,0,0,9.75292587776333,12.6137841352406,46.0338101430429,6.76202860858258
"510131009001",1332,1150,71,0,75,0,0,36,1332,1290,1125,42,1332,82,94934,182,86.3363363363363,13.6636636636637,5.33033033033033,5.63063063063063,0,0,0,2.7027027027027,3.15315315315315,84.4594594594595,6.15615615615616
"510131009002",793,680,17,0,28,7,11,50,793,716,648,77,793,30,89076,113,85.750315258512,14.249684741488,2.1437578814628,3.53089533417402,0.882723833543506,0,1.38713745271122,6.30517023959647,9.70996216897856,81.7150063051702,3.78310214375788
"510131009003",1062,798,141,0,106,0,0,17,1062,1062,798,0,1062,28,80960,264,75.1412429378531,24.8587570621469,13.2768361581921,9.98116760828625,0,0,0,1.60075329566855,0,75.1412429378531,2.63653483992467
"510131009004",1008,743,31,0,103,0,64,67,1008,824,623,184,1008,21,57224,265,73.7103174603175,26.2896825396825,3.07539682539683,10.218253968254,0,0,6.34920634920635,6.6468253968254,18.2539682539683,61.8055555555556,2.08333333333333
"510131010001",776,695,0,0,9,0,72,0,776,631,622,145,776,0,79677,81,89.5618556701031,10.4381443298969,0,1.15979381443299,0,0,9.27835051546392,0,18.6855670103093,80.1546391752577,0
"510131010002",798,746,0,0,14,0,0,38,798,757,705,41,798,0,77899,52,93.483709273183,6.51629072681705,0,1.75438596491228,0,0,0,4.76190476190476,5.13784461152882,88.3458646616541,0
"510131010003",844,642,53,0,49,0,10,90,844,749,557,95,844,44,60755,202,76.0663507109005,23.9336492890995,6.27962085308057,5.80568720379147,0,0,1.18483412322275,10.6635071090047,11.2559241706161,65.9952606635071,5.21327014218009
"510131010004",890,696,154,0,27,0,2,11,890,860,668,30,890,3,73804,194,78.2022471910112,21.7977528089888,17.3033707865169,3.03370786516854,0,0,0.224719101123596,1.23595505617978,3.37078651685393,75.0561797752809,0.337078651685393
"510131011001",1301,1153,30,0,72,0,43,3,1301,1270,1128,31,1301,26,92377,148,88.6241352805534,11.3758647194466,2.30591852421214,5.53420445810915,0,0,3.30514988470407,0.230591852421214,2.38278247501922,86.7025365103766,1.99846272098386
"510131011002",925,863,36,0,26,0,0,0,925,864,802,61,925,78,69311,62,93.2972972972973,6.70270270270269,3.89189189189189,2.81081081081081,0,0,0,0,6.5945945945946,86.7027027027027,8.43243243243243
"510131011003",1587,1407,0,0,180,0,0,0,1587,1530,1350,57,1587,24,83427,180,88.6578449905482,11.3421550094518,0,11.3421550094518,0,0,0,0,3.59168241965974,85.0661625708885,1.51228733459357
"510131011004",1290,1011,71,0,85,0,51,72,1290,1236,973,54,1290,59,98079,279,78.3720930232558,21.6279069767442,5.50387596899225,6.58914728682171,0,0,3.95348837209302,5.58139534883721,4.18604651162791,75.4263565891473,4.57364341085271
"510131011005",831,677,18,0,22,0,53,61,831,778,677,53,831,27,63613,154,81.468110709988,18.531889290012,2.16606498194946,2.647412755716,0,0,6.37785800240674,7.34055354993983,6.37785800240674,81.468110709988,3.24909747292419
"510131012001",2356,1829,87,0,155,0,240,45,2356,1640,1319,716,2171,313,43699,527,77.6315789473684,22.3684210526316,3.69269949066214,6.57894736842105,0,0,10.1867572156197,1.91001697792869,30.3904923599321,55.9847198641766,14.4173192077384
"510131012002",776,700,0,0,55,0,0,21,776,768,692,8,776,0,64282,76,90.2061855670103,9.79381443298969,0,7.08762886597938,0,0,0,2.70618556701031,1.03092783505155,89.1752577319588,0
"510131012003",905,713,17,0,39,0,49,87,905,777,651,128,905,0,60802,192,78.7845303867403,21.2154696132597,1.87845303867403,4.30939226519337,0,0,5.41436464088398,9.61325966850829,14.1436464088398,71.9337016574586,0
"510131013001",1178,1021,45,0,58,0,0,54,1178,894,760,284,1178,38,60103,157,86.6723259762309,13.3276740237691,3.82003395585739,4.92359932088285,0,0,0,4.58404074702886,24.1086587436333,64.5161290322581,3.2258064516129
"510131013002",1105,709,59,0,13,0,324,0,1105,755,683,350,1105,59,53270,396,64.1628959276018,35.8371040723982,5.3393665158371,1.17647058823529,0,0,29.3212669683258,0,31.6742081447964,61.8099547511312,5.3393665158371
"510131013003",816,704,15,18,16,0,46,17,816,749,671,67,816,0,77618,112,86.2745098039216,13.7254901960784,1.83823529411765,1.96078431372549,0,2.20588235294118,5.63725490196078,2.08333333333333,8.21078431372549,82.2303921568627,0
"510131013004",1418,1245,0,11,105,0,0,57,1418,1218,1045,200,1418,32,86801,173,87.7997179125529,12.2002820874471,0,7.40479548660085,0,0.77574047954866,0,4.0197461212976,14.1043723554302,73.6953455571227,2.25669957686883
"510131013005",1420,1313,0,0,43,0,0,64,1420,1236,1149,184,1420,32,73334,107,92.4647887323944,7.53521126760563,0,3.02816901408451,0,0,0,4.50704225352113,12.9577464788732,80.9154929577465,2.25352112676056
"510131013006",1474,1117,38,0,87,0,156,76,1474,1303,1102,171,1474,0,70640,357,75.7801899592944,24.2198100407056,2.57801899592944,5.90230664857531,0,0,10.5834464043419,5.15603799185889,11.6010854816825,74.7625508819539,0
"510131014011",1454,968,150,0,225,9,42,60,1454,1391,928,63,1454,60,71642,486,66.5749656121045,33.4250343878955,10.3163686382393,15.474552957359,0.61898211829436,0,2.88858321870702,4.12654745529574,4.33287482806052,63.8239339752407,4.12654745529574
"510131014021",503,373,18,0,95,0,0,17,503,450,320,53,503,43,73502,130,74.155069582505,25.844930417495,3.57852882703777,18.8866799204771,0,0,0,3.37972166998012,10.5367793240557,63.6182902584493,8.54870775347912
"510131014022",741,608,25,0,89,0,0,19,741,675,542,66,734,70,97398,133,82.051282051282,17.948717948718,3.37381916329285,12.0107962213225,0,0,0,2.56410256410256,8.90688259109312,73.1443994601889,9.53678474114441
"510131014023",1118,792,17,0,253,0,0,56,1118,1035,709,83,1118,67,109222,326,70.8407871198569,29.1592128801431,1.52057245080501,22.6296958855098,0,0,0,5.00894454382826,7.42397137745975,63.4168157423971,5.99284436493739
"510131014031",1715,1314,91,0,256,0,33,21,1715,1594,1226,121,1687,11,93205,401,76.6180758017493,23.3819241982507,5.30612244897959,14.9271137026239,0,0,1.92419825072886,1.22448979591837,7.05539358600583,71.4868804664723,0.652045050385299
"510131014032",393,162,0,0,215,0,0,16,393,378,147,15,393,15,56821,231,41.2213740458015,58.7786259541985,0,54.70737913486,0,0,0,4.07124681933842,3.81679389312977,37.4045801526718,3.81679389312977
"510131014033",1552,1236,107,0,135,0,16,58,1552,1398,1142,154,1552,139,78793,316,79.6391752577319,20.3608247422681,6.89432989690722,8.69845360824742,0,0,1.03092783505155,3.73711340206186,9.92268041237113,73.5824742268041,8.95618556701031
"510131014034",2342,1781,132,0,326,0,19,84,2342,2181,1708,161,2342,113,92169,561,76.0461144321093,23.9538855678907,5.63620836891546,13.9197267292912,0,0,0.811272416737831,3.5866780529462,6.87446626814688,72.9291204099061,4.82493595217763
"510131014041",5212,3893,179,15,863,0,19,243,5212,4746,3446,466,5211,411,86053,1319,74.6930161166539,25.3069838833461,3.43438219493477,16.5579432079816,0,0.287797390636992,0.364543361473523,4.66231772831926,8.94090560245587,66.1166538756715,7.88716177317214
"510131015001",1839,1421,108,0,250,0,0,60,1839,1751,1354,88,1839,197,58366,418,77.2702555736813,22.7297444263187,5.87275693311582,13.5943447525829,0,0,0,3.2626427406199,4.78520935290919,73.6269711799891,10.7123436650353
"510131015002",1431,1034,19,0,231,0,14,133,1431,1339,956,92,1431,100,99446,397,72.2571628232006,27.7428371767994,1.3277428371768,16.1425576519916,0,0,0.978336827393431,9.2941998602376,6.42907058001398,66.80642907058,6.98812019566737
"510131015003",1344,1112,52,0,95,0,16,69,1344,1285,1053,59,1344,27,129538,232,82.7380952380952,17.2619047619048,3.86904761904762,7.06845238095238,0,0,1.19047619047619,5.13392857142857,4.38988095238095,78.3482142857143,2.00892857142857
"510131015004",1041,947,25,0,29,0,0,40,1041,941,875,100,1041,27,88251,94,90.9702209414025,9.0297790585975,2.40153698366955,2.78578290105668,0,0,0,3.84245917387128,9.60614793467819,84.0537944284342,2.59365994236311
"510131015005",726,701,0,0,0,0,0,25,726,726,701,0,726,11,116710,25,96.5564738292011,3.44352617079889,0,0,0,0,0,3.4435261707989,0,96.5564738292011,1.51515151515152
"510131015006",1448,1121,166,0,109,0,0,52,1448,1078,751,370,1448,85,51988,327,77.4171270718232,22.5828729281768,11.4640883977901,7.52762430939227,0,0,0,3.59116022099448,25.5524861878453,51.8646408839779,5.87016574585635
"510131016011",935,774,19,0,57,0,32,53,935,817,695,118,935,72,100086,161,82.7807486631016,17.2192513368984,2.03208556149733,6.09625668449198,0,0,3.42245989304813,5.66844919786096,12.620320855615,74.331550802139,7.70053475935829
"510131016012",539,393,0,11,82,0,33,20,539,501,376,38,539,61,98160,146,72.9128014842301,27.0871985157699,0,15.2133580705009,0,2.04081632653061,6.12244897959184,3.71057513914657,7.05009276437848,69.7588126159555,11.317254174397
"510131016021",912,649,95,0,125,0,12,31,912,850,587,62,912,39,72591,263,71.1622807017544,28.8377192982456,10.4166666666667,13.7061403508772,0,0,1.31578947368421,3.39912280701754,6.79824561403509,64.3640350877193,4.27631578947368
"510131016022",817,611,61,0,131,0,14,0,817,747,555,70,817,70,63267,206,74.7858017135863,25.2141982864137,7.46634026927785,16.0342717258262,0,0,1.71358629130967,0,8.56793145654835,67.9314565483476,8.56793145654835
"510131016031",796,566,46,0,167,0,0,17,796,705,475,91,796,58,69241,230,71.105527638191,28.894472361809,5.77889447236181,20.9798994974874,0,0,0,2.1356783919598,11.4321608040201,59.6733668341708,7.28643216080402
"510131016032",2172,1491,144,0,477,0,0,60,2172,2087,1406,85,2142,244,91881,681,68.646408839779,31.353591160221,6.62983425414365,21.9613259668508,0,0,0,2.76243093922652,3.9134438305709,64.7329650092081,11.391223155929
"510131016033",971,767,27,0,54,0,40,83,971,850,700,121,971,12,196394,204,78.9907312049434,21.0092687950566,2.78063851699279,5.56127703398558,0,0,4.11946446961895,8.54788877445932,12.4613800205973,72.0906282183316,1.23583934088568
"510131017011",723,397,35,0,28,40,142,81,723,491,395,232,723,99,43533,326,54.9100968188105,45.0899031811895,4.84094052558783,3.87275242047026,5.53250345781466,0,19.640387275242,11.2033195020747,32.088520055325,54.6334716459198,13.6929460580913
"510131017012",1765,1546,21,0,90,0,104,4,1765,1348,1233,417,1765,149,66075,219,87.5920679886686,12.4079320113314,1.18980169971671,5.09915014164306,0,0,5.89235127478754,0.226628895184136,23.6260623229462,69.8583569405099,8.44192634560907
"510131017013",807,466,259,0,82,0,0,0,807,677,347,130,366,0,73409,341,57.7447335811648,42.2552664188352,32.094175960347,10.1610904584882,0,0,0,0,16.1090458488228,42.998760842627,0
"510131017014",1621,1227,22,0,226,0,61,85,1621,1543,1211,78,1621,103,103256,394,75.6940160394818,24.3059839605182,1.3571869216533,13.9420111042566,0,0,3.76310919185688,5.24367674275139,4.81184454040716,74.7069710055521,6.35410240592227
"510131017021",1753,1005,0,0,521,0,25,202,1753,1632,884,121,1753,180,55750,748,57.3302909298346,42.6697090701654,0,29.7204791785511,0,0,1.42612664004564,11.5231032515687,6.90245293782088,50.4278379920137,10.2681118083286
"510131017022",2143,1490,111,0,465,0,39,38,2143,1818,1221,325,2133,111,85116,653,69.5286980867942,30.4713019132058,5.17965468968735,21.6985534297713,0,0,1.81987867475502,1.77321511899207,15.1656556229585,56.9762015865609,5.20393811533052
"510131017023",1488,1178,74,0,213,0,0,23,1488,1291,981,197,1488,50,91919,310,79.1666666666667,20.8333333333333,4.97311827956989,14.3145161290323,0,0,0,1.54569892473118,13.239247311828,65.9274193548387,3.36021505376344
"510131017031",1120,753,202,0,153,12,0,0,1120,1059,692,61,1120,142,73233,367,67.2321428571429,32.7678571428571,18.0357142857143,13.6607142857143,1.07142857142857,0,0,0,5.44642857142857,61.7857142857143,12.6785714285714
"510131017032",1171,1037,55,0,41,0,11,27,1171,1089,966,82,1171,133,118991,134,88.5567890691716,11.4432109308284,4.69684030742955,3.50128095644748,0,0,0.939368061485909,2.30572160546541,7.00256191289496,82.4935952177626,11.3578138343296
"510131018011",3664,2800,93,21,573,0,46,131,3664,3396,2556,268,3664,113,105049,864,76.4192139737991,23.5807860262009,2.5382096069869,15.6386462882096,0,0.573144104803494,1.25545851528384,3.57532751091703,7.31441048034935,69.7598253275109,3.08406113537118
"510131018021",1308,896,114,0,204,0,19,75,1308,1268,875,40,1308,108,84926,412,68.5015290519878,31.4984709480122,8.71559633027523,15.5963302752294,0,0,1.4525993883792,5.73394495412844,3.05810397553517,66.8960244648318,8.25688073394496
"510131018022",1860,1392,99,0,191,0,0,178,1860,1511,1268,349,1860,69,93378,468,74.8387096774194,25.1612903225806,5.32258064516129,10.2688172043011,0,0,0,9.56989247311828,18.7634408602151,68.1720430107527,3.70967741935484
"510131018023",1369,1173,70,20,52,0,21,33,1369,1119,964,250,1369,54,68604,196,85.6829802775749,14.3170197224251,5.11322132943755,3.79839298758218,0,1.4609203798393,1.53396639883126,2.41051862673484,18.2615047479912,70.4163623082542,3.94448502556611
"510131018024",1358,639,195,0,149,0,281,94,1358,774,336,584,1358,267,27673,719,47.0544918998527,52.9455081001473,14.359351988218,10.9720176730486,0,0,20.6921944035346,6.9219440353461,43.0044182621502,24.7422680412371,19.6612665684831
"510131018025",1092,1005,0,0,16,0,28,43,1092,907,848,185,1092,33,75639,87,92.032967032967,7.96703296703298,0,1.46520146520147,0,0,2.56410256410256,3.93772893772894,16.9413919413919,77.6556776556777,3.02197802197802
"510131018031",878,773,72,0,33,0,0,0,878,837,773,41,878,113,73905,105,88.0410022779043,11.9589977220957,8.2004555808656,3.75854214123007,0,0,0,0,4.66970387243736,88.0410022779043,12.870159453303
"510131018032",1301,975,111,0,86,0,78,51,1301,1243,934,58,1301,101,67779,326,74.9423520368947,25.0576479631053,8.53189853958493,6.61029976940815,0,0,5.99538816295158,3.92006149116065,4.45810914681015,71.7909300538048,7.76325903151422
"510131018033",993,548,0,0,190,0,255,0,993,705,515,288,993,136,35755,445,55.1863041289023,44.8136958710977,0,19.1339375629406,0,0,25.6797583081571,0,29.0030211480363,51.8630412890232,13.6958710976838
"510131018034",1383,1221,21,0,78,0,17,46,1383,1332,1187,51,1383,14,87462,162,88.2863340563991,11.7136659436009,1.51843817787419,5.63991323210412,0,0,1.2292118582791,3.32610267534346,3.68763557483731,85.8279103398409,1.01229211858279
"510131019001",980,746,44,0,43,0,100,47,980,848,714,132,945,69,71485,234,76.1224489795918,23.8775510204082,4.48979591836735,4.38775510204082,0,0,10.2040816326531,4.79591836734694,13.469387755102,72.8571428571428,7.3015873015873
"510131019002",1541,1433,0,0,66,0,0,42,1541,1533,1425,8,1541,67,82220,108,92.9915639195328,7.00843608046723,0,4.28293316028553,0,0,0,2.7255029201817,0.519143413367943,92.4724205061648,4.34782608695652
"510131019003",766,720,0,0,18,0,19,9,766,766,720,0,766,22,83976,46,93.9947780678851,6.00522193211488,0,2.34986945169713,0,0,2.48041775456919,1.17493472584856,0,93.9947780678851,2.87206266318538
"510131020011",1656,467,96,0,235,0,760,98,1656,858,444,798,1656,130,45571,1189,28.2004830917874,71.7995169082126,5.79710144927536,14.1908212560386,0,0,45.8937198067633,5.91787439613527,48.1884057971014,26.8115942028986,7.85024154589372
"510131020012",1351,1003,139,0,125,0,32,52,1351,1119,814,232,1351,213,78448,348,74.2413027387121,25.7586972612879,10.2886750555144,9.25240562546262,0,0,2.36861584011843,3.84900074019245,17.1724648408586,60.2516654330126,15.7660991857883
"510131020021",1414,999,91,0,196,40,35,53,1414,1197,836,217,1412,83,56819,415,70.6506364922207,29.3493635077793,6.43564356435644,13.8613861386139,2.82885431400283,0,2.47524752475248,3.74823196605375,15.3465346534653,59.1230551626591,5.87818696883853
"510131020031",1854,1053,371,0,254,0,99,77,1854,1648,973,206,1854,437,48067,801,56.7961165048544,43.2038834951456,20.0107874865156,13.7001078748652,0,0,5.33980582524272,4.15318230852211,11.1111111111111,52.4811218985976,23.5706580366775
"510131020032",1667,1099,190,0,49,0,309,20,1667,846,607,821,1667,93,38753,568,65.9268146370726,34.0731853629274,11.3977204559088,2.93941211757648,0,0,18.5362927414517,1.1997600479904,49.250149970006,36.4127174565087,5.57888422315537
"510131020033",520,381,68,0,42,0,0,29,520,482,343,38,520,109,57818,139,73.2692307692308,26.7307692307692,13.0769230769231,8.07692307692308,0,0,0,5.57692307692308,7.30769230769231,65.9615384615385,20.9615384615385
"510131021001",825,461,103,23,238,0,0,0,825,754,390,71,702,262,39902,364,55.8787878787879,44.1212121212121,12.4848484848485,28.8484848484849,0,2.78787878787879,0,0,8.60606060606061,47.2727272727273,37.3219373219373
"510131021002",1569,1299,22,8,144,0,57,39,1569,1497,1253,72,1569,85,72764,270,82.791586998088,17.208413001912,1.40216698534098,9.17782026768642,0,0.509878903760357,3.63288718929254,2.48565965583174,4.58891013384321,79.8597833014659,5.41746335245379
"510131022001",1096,709,105,0,74,0,125,83,1096,480,218,616,1051,96,44063,387,64.6897810218978,35.3102189781022,9.58029197080292,6.75182481751825,0,0,11.4051094890511,7.57299270072993,56.2043795620438,19.8905109489051,9.13415794481446
"510131022002",1664,901,515,76,153,0,0,19,1664,787,104,877,1664,307,22975,763,54.1466346153846,45.8533653846154,30.9495192307692,9.19471153846154,0,4.56730769230769,0,1.14182692307692,52.7043269230769,6.25,18.4495192307692
"510131022003",1214,708,385,0,5,0,90,26,1214,764,374,450,1214,630,22289,506,58.3196046128501,41.6803953871499,31.7133443163097,0.411861614497529,0,0,7.41350906095552,2.14168039538715,37.0675453047776,30.8072487644152,51.8945634266886
"510131022004",1477,439,698,0,271,0,27,42,1477,1160,202,317,1477,46,26778,1038,29.7224102911307,70.2775897088693,47.2579553148274,18.3480027081923,0,0,1.8280297901151,2.8436018957346,21.4624238320921,13.6763710223426,3.1144211238998
"510131022005",2769,1114,927,40,164,0,363,161,2769,1484,234,1285,2769,444,21289,1655,40.2311303719754,59.7688696280246,33.477789815818,5.92271578187071,0,1.44456482484652,13.1094257854821,5.81437342000722,46.4066449981943,8.45070422535211,16.0346695557963
"510131023011",908,755,52,0,26,0,6,69,908,831,707,77,908,32,75328,153,83.1497797356828,16.8502202643172,5.72687224669604,2.86343612334802,0,0,0.66079295154185,7.59911894273128,8.48017621145375,77.863436123348,3.52422907488987
"510131023012",525,351,55,0,80,0,19,20,525,477,322,48,525,10,81767,174,66.8571428571429,33.1428571428571,10.4761904761905,15.2380952380952,0,0,3.61904761904762,3.80952380952381,9.14285714285714,61.3333333333333,1.9047619047619
"510131023021",560,372,8,0,70,0,101,9,560,347,231,213,560,30,44328,188,66.4285714285714,33.5714285714286,1.42857142857143,12.5,0,0,18.0357142857143,1.60714285714286,38.0357142857143,41.25,5.35714285714286
"510131023022",1101,502,0,0,50,0,549,0,1101,496,446,605,1101,371,26237,599,45.5949137148047,54.4050862851953,0,4.54132606721163,0,0,49.8637602179836,0,54.9500454132607,40.5086285195277,33.6966394187103
"510131023023",1137,721,251,0,94,0,7,64,1137,994,621,143,1137,8,56158,416,63.4124890061565,36.5875109938435,22.07563764292,8.26737027264732,0,0,0.615655233069481,5.62884784520668,12.5769569041337,54.6174142480211,0.703605980650836
"510131023024",1477,1064,115,0,148,0,104,46,1477,1211,912,266,1477,39,78903,413,72.0379146919431,27.9620853080569,7.78605280974949,10.0203114421124,0,0,7.04129993229519,3.1144211238998,18.0094786729858,61.7467840216655,2.6404874746107
"510131024001",971,590,205,0,110,0,48,18,971,900,567,71,971,35,52987,381,60.7621009268795,39.2378990731205,21.1122554067971,11.3285272914521,0,0,4.94335736354274,1.85375901132853,7.31204943357363,58.3934088568486,3.60453141091658
"510131024002",976,731,38,0,67,0,140,0,976,581,476,395,976,92,44466,245,74.8975409836066,25.1024590163934,3.89344262295082,6.86475409836066,0,0,14.344262295082,0,40.4713114754098,48.7704918032787,9.42622950819672
"510131024003",816,628,31,0,71,0,60,26,816,723,595,93,816,15,61821,188,76.9607843137255,23.0392156862745,3.79901960784314,8.70098039215686,0,0,7.35294117647059,3.18627450980392,11.3970588235294,72.9166666666667,1.83823529411765
"510131024004",586,439,109,0,26,0,12,0,586,574,439,12,586,0,92198,147,74.9146757679181,25.0853242320819,18.6006825938567,4.43686006825939,0,0,2.04778156996587,0,2.04778156996587,74.9146757679181,0
"510131025001",2096,1408,360,0,179,0,6,143,2096,1560,896,536,2096,38,54966,688,67.175572519084,32.824427480916,17.175572519084,8.54007633587786,0,0,0.286259541984733,6.82251908396946,25.5725190839695,42.7480916030534,1.81297709923664
"510131025002",2124,1358,453,25,211,0,19,58,2124,1842,1125,282,2124,164,66130,766,63.9359698681733,36.0640301318267,21.3276836158192,9.93408662900188,0,1.17702448210923,0.894538606403013,2.73069679849341,13.2768361581921,52.9661016949153,7.72128060263653
"510131025003",1467,1323,50,0,53,0,21,20,1467,1194,1071,273,1467,12,64222,144,90.1840490797546,9.8159509202454,3.40831629175187,3.61281526925699,0,0,1.43149284253579,1.36332651670075,18.6094069529652,73.0061349693252,0.81799591002045
"510131026001",2615,1692,434,0,78,0,330,81,2615,1740,1188,875,2615,129,46981,923,64.7036328871893,35.2963671128107,16.5965583173996,2.98279158699809,0,0,12.6195028680688,3.09751434034417,33.4608030592734,45.4302103250478,4.93307839388145
"510131026002",1069,697,67,3,192,0,35,75,1069,807,470,262,1069,18,65776,372,65.2011225444341,34.7988774555659,6.26753975678204,17.9607109448082,0,0.280636108512629,3.27408793264733,7.01590271281572,24.5088868101029,43.9663236669785,1.68381665107577
"510131027011",3578,809,1178,20,795,0,560,216,3578,2416,321,1162,3523,371,26066,2769,22.6103968697596,77.3896031302404,32.9234209055338,22.2191168250419,0,0.558971492453885,15.6512017887088,6.03689211850196,32.4762437115707,8.97149245388485,10.5307976156685
"510131027012",557,266,127,28,33,0,38,65,557,400,212,157,557,77,30481,291,47.7558348294434,52.2441651705566,22.8007181328546,5.9245960502693,0,5.02692998204668,6.82226211849192,11.6696588868941,28.1867145421903,38.0610412926391,13.8240574506284
"510131027021",1263,833,69,7,104,0,188,62,1263,906,708,357,1263,12,64825,430,65.9540775930325,34.0459224069675,5.46318289786223,8.23436262866192,0,0.554235946159937,14.8851939825812,4.9089469517023,28.2660332541568,56.0570071258907,0.950118764845606
"510131027022",799,360,38,0,178,0,169,54,799,469,253,330,778,64,28723,439,45.0563204005006,54.9436795994994,4.75594493116396,22.2778473091364,0,0,21.1514392991239,6.75844806007509,41.3016270337922,31.6645807259074,8.22622107969152
"510131028011",2570,907,706,0,246,0,643,68,2570,1738,718,832,2570,215,50609,1663,35.2918287937743,64.7081712062257,27.4708171206226,9.57198443579767,0,0,25.0194552529183,2.64591439688716,32.3735408560311,27.9377431906615,8.36575875486381
"510131028012",922,524,36,0,214,0,115,33,922,570,259,352,922,25,40239,398,56.8329718004338,43.1670281995662,3.90455531453362,23.2104121475054,0,0,12.472885032538,3.57917570498915,38.177874186551,28.0911062906725,2.7114967462039
"510131028013",1357,759,37,0,169,0,364,28,1357,416,182,941,1357,2,43893,598,55.9322033898305,44.0677966101695,2.72660280029477,12.4539425202653,0,0,26.8238761974945,2.06337509211496,69.3441414885777,13.4119380987472,0.147383935151069
"510131028014",975,609,37,0,264,0,65,0,975,840,564,135,975,55,53767,366,62.4615384615385,37.5384615384615,3.7948717948718,27.0769230769231,0,0,6.66666666666667,0,13.8461538461538,57.8461538461538,5.64102564102564
"510131028015",1807,858,352,0,568,0,29,0,1807,1348,440,459,1795,111,55560,949,47.4820143884892,52.5179856115108,19.4798007747648,31.4333148865523,0,0,1.60486995019369,0,25.4012174875484,24.349750968456,6.18384401114206
"510131028016",824,546,32,0,71,0,64,111,824,615,401,209,824,116,23992,278,66.2621359223301,33.7378640776699,3.88349514563107,8.61650485436893,0,0,7.76699029126214,13.4708737864078,25.3640776699029,48.6650485436893,14.0776699029126
"510131028021",660,575,48,0,16,0,12,9,660,569,496,91,660,8,63750,85,87.1212121212121,12.8787878787879,7.27272727272727,2.42424242424242,0,0,1.81818181818182,1.36363636363636,13.7878787878788,75.1515151515151,1.21212121212121
"510131028022",723,630,27,0,27,0,0,39,723,559,466,164,723,4,52039,93,87.1369294605809,12.8630705394191,3.7344398340249,3.7344398340249,0,0,0,5.39419087136929,22.6832641770401,64.4536652835408,0.553250345781466
"510131029011",986,887,73,0,18,0,0,8,986,841,764,145,986,31,77960,99,89.9594320486815,10.0405679513185,7.40365111561866,1.82555780933063,0,0,0,0.811359026369168,14.7058823529412,77.4847870182556,3.14401622718053
"510131029012",928,793,36,0,21,0,27,51,928,800,715,128,928,8,87947,135,85.4525862068966,14.5474137931034,3.87931034482759,2.26293103448276,0,0,2.90948275862069,5.49568965517241,13.7931034482759,77.0474137931034,0.862068965517241
"510131029013",1004,910,0,0,7,0,29,58,1004,925,860,79,1004,16,73652,94,90.6374501992032,9.36254980079681,0,0.697211155378486,0,0,2.88844621513944,5.77689243027888,7.86852589641434,85.6573705179283,1.59362549800797
"510131029021",2701,2011,208,93,79,22,109,179,2701,2014,1526,687,2689,57,72959,690,74.4539059607553,25.5460940392447,7.70085153646797,2.92484265087005,0.814513143280266,3.44316919659385,4.03554239170677,6.62717512032581,25.435024065161,56.4975934838949,2.11974711788769
"510131029022",1574,1321,77,0,107,0,0,69,1574,1519,1266,55,1574,24,74660,253,83.9263024142313,16.0736975857687,4.89199491740788,6.79796696315121,0,0,0,4.38373570520966,3.49428208386277,80.4320203303685,1.52477763659466
"510131030001",1163,1038,11,24,24,0,27,39,1163,1033,959,130,1163,12,76405,125,89.2519346517627,10.7480653482373,0.945829750644884,2.06362854686156,0,2.06362854686156,2.32158211521926,3.35339638865004,11.1779879621668,82.4591573516767,1.03181427343078
"510131030002",896,733,0,0,136,0,0,27,896,884,721,12,896,8,66395,163,81.8080357142857,18.1919642857143,0,15.1785714285714,0,0,0,3.01339285714286,1.33928571428571,80.46875,0.892857142857143
"510131030003",1387,1305,24,0,28,0,0,30,1387,1316,1234,71,1387,22,79142,82,94.0879596250901,5.91204037490988,1.73035328046143,2.01874549387167,0,0,0,2.16294160057678,5.11896178803172,88.9689978370584,1.58615717375631
"510131031001",2837,1426,797,0,104,0,295,215,2837,2027,947,810,2837,403,35837,1411,50.26436376454,49.73563623546,28.0930560451181,3.66584420162143,0,0,10.3983080719069,7.57842791681353,28.5512865703208,33.3803313359182,14.205146281283
"510131031002",1759,1085,570,2,87,0,0,15,1759,1163,489,596,1734,508,51455,674,61.6827743035816,38.3172256964184,32.4047754405912,4.94599204093235,0,0.113700966458215,0,0.852757248436612,33.882888004548,27.7998862990335,29.2964244521338
"510131031003",1364,516,288,0,96,0,447,17,1364,882,459,482,1364,71,56077,848,37.8299120234604,62.1700879765396,21.1143695014663,7.03812316715543,0,0,32.7712609970675,1.24633431085044,35.3372434017595,33.6510263929619,5.20527859237537
"510131032001",1478,491,90,85,514,0,298,0,1478,1298,397,180,1478,48,43239,987,33.2205683355886,66.7794316644114,6.0893098782138,34.7767253044655,0,5.7510148849797,20.1623815967524,0,12.1786197564276,26.8606224627876,3.24763193504736
"510131032002",1828,615,554,0,595,0,43,21,1828,1779,594,49,1828,126,43018,1213,33.6433260393873,66.3566739606127,30.3063457330416,32.5492341356674,0,0,2.35229759299781,1.14879649890591,2.68052516411379,32.4945295404814,6.89277899343545
"510131032003",928,830,20,0,32,0,0,46,928,808,710,120,928,47,76222,98,89.4396551724138,10.5603448275862,2.1551724137931,3.44827586206897,0,0,0,4.95689655172414,12.9310344827586,76.5086206896552,5.06465517241379
"510131032004",1697,1062,72,49,154,19,284,57,1697,1235,933,462,1697,27,62309,635,62.5810253388332,37.4189746611668,4.24278137890395,9.07483794932233,1.11962286387743,2.88744843842074,16.73541543901,3.35886859163229,27.224513847967,54.979375368297,1.59104301708898
"510131033001",1165,423,648,0,0,0,0,94,1165,1044,362,121,1165,225,42008,742,36.3090128755365,63.6909871244635,55.6223175965665,0,0,0,0,8.068669527897,10.3862660944206,31.0729613733906,19.31330472103
"510131033002",1284,718,210,0,227,0,0,129,1284,1140,655,144,1284,143,48239,566,55.9190031152648,44.0809968847352,16.3551401869159,17.6791277258567,0,0,0,10.0467289719626,11.214953271028,51.01246105919,11.1370716510903
"510131034011",1353,1012,161,41,54,42,43,0,1353,1097,799,256,117,0,24365,341,74.7967479674797,25.2032520325203,11.8994826311899,3.99113082039911,3.10421286031042,3.03030303030303,3.17812269031781,0,18.9209164818921,59.0539541759054,0
"510131034021",946,751,25,46,32,0,0,92,946,814,680,132,946,0,93325,195,79.3868921775899,20.6131078224101,2.64270613107822,3.38266384778013,0,4.86257928118393,0,9.72515856236786,13.953488372093,71.8816067653277,0
"510131034022",870,434,142,0,259,0,0,35,870,798,397,72,870,217,67423,436,49.8850574712644,50.1149425287356,16.3218390804598,29.7701149425287,0,0,0,4.02298850574713,8.27586206896552,45.632183908046,24.9425287356322
"510131034023",1485,897,142,0,318,0,40,88,1485,1313,769,172,1485,147,80694,588,60.4040404040404,39.5959595959596,9.56228956228956,21.4141414141414,0,0,2.69360269360269,5.92592592592593,11.5824915824916,51.7845117845118,9.8989898989899
"510131034024",897,584,122,0,77,48,0,66,897,859,546,38,897,0,88899,313,65.1059085841695,34.8940914158305,13.6008918617614,8.58416945373467,5.35117056856187,0,0,7.35785953177258,4.23634336677815,60.8695652173913,0
"510131034025",1721,1064,345,0,227,0,0,85,1721,1639,1004,82,1721,78,82140,657,61.8245206275421,38.1754793724579,20.0464846019756,13.1900058105752,0,0,0,4.93898895990703,4.76467170249855,58.3381754793725,4.53224869262057
"510131035011",1026,741,145,15,76,0,0,49,1026,884,649,142,1026,67,70473,285,72.2222222222222,27.7777777777778,14.1325536062378,7.40740740740741,0,1.46198830409357,0,4.77582846003899,13.8401559454191,63.2553606237817,6.53021442495127
"510131035012",408,325,17,0,14,0,0,52,408,293,210,115,408,0,73676,83,79.656862745098,20.343137254902,4.16666666666667,3.43137254901961,0,0,0,12.7450980392157,28.1862745098039,51.4705882352941,0
"510131035013",1716,1417,49,0,238,0,0,12,1716,1410,1111,306,1716,156,84891,299,82.5757575757576,17.4242424242424,2.85547785547786,13.8694638694639,0,0,0,0.699300699300699,17.8321678321678,64.7435897435898,9.09090909090909
"510131035021",3807,2226,530,0,673,0,86,292,3807,3203,1848,604,3807,395,81252,1581,58.4712371946414,41.5287628053586,13.9217231415813,17.6779616495929,0,0,2.25899658523772,7.67008142894668,15.8655109009719,48.542159180457,10.3756238508012
"510131035022",1134,677,313,0,119,0,4,21,1134,1091,654,43,974,285,43629,457,59.700176366843,40.299823633157,27.6014109347443,10.4938271604938,0,0,0.352733686067019,1.85185185185185,3.79188712522046,57.6719576719577,29.2607802874743
"510131035031",2482,1461,284,0,476,0,43,218,2482,2416,1438,66,2482,82,72699,1021,58.8638195004029,41.1361804995971,11.4423851732474,19.1780821917808,0,0,1.73247381144239,8.78323932312651,2.65914585012087,57.9371474617244,3.30378726833199
"510131035032",1997,1155,251,39,463,0,0,89,1997,1796,971,201,1997,291,56005,842,57.836755132699,42.163244867301,12.5688532799199,23.1847771657486,0,1.95292939409114,0,4.45668502754131,10.0650976464697,48.6229344016024,14.57185778668
"510131036011",1010,925,0,0,68,0,0,17,1010,950,865,60,1003,28,77205,85,91.5841584158416,8.41584158415841,0,6.73267326732673,0,0,0,1.68316831683168,5.94059405940594,85.6435643564356,2.79162512462612
"510131036012",722,611,2,0,65,0,11,33,722,660,549,62,722,32,68374,111,84.6260387811634,15.3739612188366,0.277008310249307,9.00277008310249,0,0,1.52354570637119,4.57063711911357,8.58725761772853,76.0387811634349,4.43213296398892
"510131036013",1026,744,20,0,46,0,161,55,1026,802,681,224,1026,59,56920,282,72.5146198830409,27.4853801169591,1.94931773879142,4.48343079922027,0,0,15.692007797271,5.36062378167641,21.8323586744639,66.3742690058479,5.7504873294347
"510131036021",542,392,10,0,127,0,0,13,542,411,261,131,542,97,51270,150,72.3247232472325,27.6752767527675,1.8450184501845,23.4317343173432,0,0,0,2.39852398523985,24.169741697417,48.1549815498155,17.8966789667897
"510131036022",681,390,84,0,186,0,7,14,681,546,262,135,681,81,49543,291,57.2687224669604,42.7312775330396,12.3348017621145,27.3127753303965,0,0,1.02790014684288,2.05580029368576,19.8237885462555,38.4728340675477,11.8942731277533
"510131037001",956,822,30,0,62,0,0,42,956,861,727,95,948,10,109861,134,85.9832635983264,14.0167364016736,3.13807531380753,6.48535564853557,0,0,0,4.39330543933054,9.93723849372385,76.0460251046025,1.05485232067511
"510131037002",1660,1428,45,0,101,0,60,26,1660,1413,1233,247,1660,61,84214,232,86.0240963855422,13.9759036144578,2.71084337349398,6.08433734939759,0,0,3.6144578313253,1.56626506024096,14.8795180722892,74.2771084337349,3.67469879518072
"510131038001",3241,2130,816,0,216,0,36,43,3241,2799,1748,442,3241,280,53282,1111,65.7204566491824,34.2795433508176,25.1774143782783,6.66460968836779,0,0,1.11076828139463,1.32675100277692,13.6377661215674,53.933970996606,8.63930885529158
"510131038002",881,497,130,0,19,0,190,45,881,610,416,271,881,144,47743,384,56.4131668558456,43.5868331441544,14.7559591373439,2.1566401816118,0,0,21.566401816118,5.10783200908059,30.7604994324631,47.2190692395006,16.3450624290579
"510131038003",905,581,195,44,85,0,0,0,905,831,507,74,905,0,67750,324,64.1988950276243,35.8011049723757,21.5469613259669,9.39226519337017,0,4.86187845303867,0,0,8.1767955801105,56.0220994475138,0
"510139801001",0,0,0,0,0,0,0,0,0,0,0,0,0,0,0,0,0,0,0,0,0,0,0,0,0,0,0
"510139802001",4,4,0,0,0,0,0,0,4,4,4,0,4,0,0,0,100,0,0,0,0,0,0,0,0,100,0
